          NO    xpms/1.xpm 
SO xpms/2.xpm
    WE       xpms/711892.xpm
           EA xpms/3.xpm
    F  220, 100,   255       
 C 225, 30,1 
 
 
 
 
1111111111111111111111
1000000000000000000001
100000000000000000000111
1000000001110000000000001
1000000000000101100000001
100000000N0000000110000011
100000000001110000011000001
100000000110000000000111001
100000111000000000000001111
1111111111111111111111011011111
100000000111100000001101111111
1000000000000000000000000000001
11111111111111111111111111111111