          NO   xpms/wall5.xpm
    WE       xpms/wall6.xpm
SO xpms/wall7.xpm
           EA xpms/wall8.xpm
    F  100,100,100      
 C 0, 100,250 
 
 
 
 
1111111111111111111111
1000000000000000000001
100000000000000000000111
1000000001110000000000001
100000000100001011000000011
1000000001E00000000110000011
1000000000001110000011000001
1000000001100000000001110011
100000111000000000000001111
1111111111111111111111011011111
100000000111100000001101111111
1000000000000000000000000000001
11111111111111111111111111111111