          NO   xpms/wall5.xpm
           EA xpms/wall8.xpm
    WE       xpms/wall6.xpm
SO xpms/wall7.xpm
 C 10,10,100 
    F  100,100,100      

                    

1
11111111111111111111111
1000000000000000000001
1111111111111111111111  
111111111111111111111
1000000000000000000001
1000000000000000000011111
1000000000000000000000111111
1000000000E000001011000000011
100000000000000000011000001
1000000000001110000011000001
10000000001100000000001110011
100000111000000000000001111
1111111111111111111111011011111
100000000111100000001101111111
1000000000000000000000000000001
1111111111111111111111111111111
1111111111111111111111111111
1111111111111111111111111111111
1111111111111 11111111111111111
